gothic	old_english
haubiþ	hēafod
augō	ēage
ausō	ēare
munþs	mūþ
handus	hand
fōtus	fōt
haírtō	heorte
blōþ	blōd
fadar	fæder
aiþei	mōdor
sunus	sunu
dauhtar	dohtor
brōþar	brōþor
watō	wæter
fōn	fȳr
sunnō	sunne
mēna	mōna
staírnō	steorra
aírþa	eorþe
faírguni	beorg
stains	stān
triu	trēow
fisks	fisc
fugls	fugol
auhsa	oxa
itan	etan
drigkan	drincan
giban	giefan
qiman	cuman
diwan	steorfan
kunnan	cunnan
hausjan	hīeran
saíƕan	sēon
namō	nama
guþ	god
þiudans	cyning
razn	hūs
