gothic	old_norse
haubiþ	hǫfuð
augō	auga
ausō	eyra
munþs	munnr
handus	hǫnd
fōtus	fótr
haírtō	hjarta
blōþ	blóð
fadar	faðir
aiþei	móðir
sunus	sunr
dauhtar	dóttir
brōþar	bróðir
watō	vatn
fōn	eldr
sunnō	sól
mēna	máni
staírnō	stjarna
aírþa	jǫrð
faírguni	fjall
stains	steinn
triu	tré
fisks	fiskr
fugls	fugl
auhsa	uxi
itan	eta
drigkan	drekka
giban	gefa
qiman	koma
diwan	deyja
kunnan	kunna
hausjan	heyra
saíƕan	sjá
namō	nafn
guþ	guð
þiudans	konungr
razn	hús
