gothic	proto_germanic
haubiþ	houbit
augō	ouga
ausō	ōra
munþs	mund
handus	hant
fōtus	fuoz
haírtō	herza
blōþ	bluot
fadar	fater
aiþei	muoter
sunus	sunu
dauhtar	tohter
brōþar	bruoder
watō	wazzar
fōn	fiur
sunnō	sunna
mēna	māno
staírnō	sterno
aírþa	erda
faírguni	berg
stains	stein
triu	boum
fisks	fisc
fugls	fogal
auhsa	ohso
itan	ezzan
drigkan	trinkan
giban	geban
qiman	queman
diwan	sterban
kunnan	kunnan
hausjan	hōren
saíƕan	sehan
namō	namo
guþ	got
þiudans	kuning
razn	hūs
